0000000000000000000000000000000000000000000000000000000000000000000000000000000
0000000000000000000000000000000000000000000000000000000000000000000000000000000
0000000000000000000000000000000000000000000000000000000000000000000000000000000
0000000000000000000000000000000000000000000000000000000000000000000000000000000
0000000000000000000000000000000000000000000000000000000000000000000000000000000
0000000000000000000000000000000000000000000000000000000000000000000000000000000
0000000000000000000000000000000000000000000000000000000000000000000000000000000
0000000000000000000000000000000000000000000000000000000000000000000000000000000
0000000000000000000000000000000000000000000000000000000000000000000000000000000
0000000000000000000000000000000000000000000000000000000000000000000000000000000
0000000000000000000000000000000000000000000000000000000000000000000000000000000
0000000000000000000000000000000000000000000000000000000000000000000000000000000
0000000000000000000000000000000000000000000000000000000000000000000000000000000
4000000000000000000000000000000000000000000000000000000000000000000000000000000
3000001000000000000000000000000000000000000000000000000000000000000000000000000
3000000000000444444400000000000000000000004444444444000000000000000040000000000
3000000000000000000000000000000000000000000000000000000000000000000030000000000
3000000000000000000000000000000000000000000000000000000000000000000030000000000
300000000000000000000000000000000000000000000000000000000000000000003000000b000
3000000000000000000000000000000000000000000000000000000000000000000030000000000
34444444444444444444440004444444444444444aaaaaa44444444440000444444434444444444
3333333333333333333333000333333333333333333333333333333330000333333333333333333
3333333333333333333333000333333333333333333333333333333330000333333333333333333
