0000000000000000000000000000000000000000000000000000000000000000000000000000000
0000000000000000000000000000000000000000000000000000000000000000000000000000000
0000000000000000000000000000000000000000000000000000000000000000000000000000000
0000000000000000000000000000000000000000000000000000000000000000000000000000000
0000000000000000000000000000000000000000000000000000000000000000000000000000000
0000000000000000000000000000000000000000000000000000000000000000000000000000000
0000000000000000000000000000000000000000000000000000000000000000000000000000000
0000000000000000000000000000000000000000000000000000000000000000000000000000000
0000000000000000000000000000000000000000000000000000000000000000000000000000000
0000000000000000000000000000000000000000000000000000000000000000000000000000000
0000000000000000000000000000000000000000000000000000000000000000000000000000000
0000000000000000000000000000000000000000000000000000000000000000000000000000000
0000000000000000000000000000000000000000000000000000000000000000000000000000000
3000000000000000000000000000000000000000000000000000000000000000000000000000000
3000001000000000000000000000000000000000000000000000000000000000000000000000000
3000000000000333333300000000000000000000003333333333000000000000000030000000000
3000000000000000000000000000000000000000000000000000000000000000000030000000000
3000000000000000000000000000000000000000000000000000000000000000000030000000000
3000000000000000000000000000000000000000000000000000000000000000000030000000000
3000000000000000000000000000000000000000000000000000000000000000000030000000000
3333333333333333333333000333333333333333333333333333333330000333333333333333333
3333333333333333333333000333333333333333333333333333333330000333333333333333333
3333333333333333333333000333333333333333333333333333333330000333333333333333333
